
###########################
#J#####MMMMMMMMM##B########
#MM######MMMO####MMM#######
##MMMC####MMMMM##MMMMMMM###
##MMMM#######M#MMMMMMOMMMM#
#####M#######A#MMMCMMMM####
#MMMMMMMMMMMDC#MMMMMM######
#A#####M###M#####MMMM######
#C#####MMMMMMMMMMMMMOMDCMM#
#BOMMMMMMMMMMMM########MMM#
###########################