
###########################
#JMM####MMMMMMMMBMM####MMC#
#M#MMMMMM####D####MMMMMM#M#
#M#####M###BMMMM#####M###M#
#MMMOMMMMMDM#C#MDMMMMMMMMO#
#######D###M###M#M####A####
#MMOMMMMMMDM#C#MDMMMMMMOMM#
#A####MM#M#MMMMM#M#D#####D#
#MMMMMMM#M#######M#MMMMMMM#
##C##MMMBMMMMDMMMM#M#M##C##
###########################